"filename", "language", "YAML", "Dart", "TypeScript", "comment", "blank", "total"
"d:\Proyecto\citasnuevo\FuncionesNubeFirebase\functions\src\darValoraciones\darValoraciones.ts", "TypeScript", 0, 0, 2, 0, 4, 6
"d:\Proyecto\citasnuevo\FuncionesNubeFirebase\functions\src\solicitarUsuarios\solicitarUsuarios.ts", "TypeScript", 0, 0, 191, 29, 164, 384
"d:\Proyecto\citasnuevo\FuncionesNubeFirebase\functions\src\test\index.test.ts", "TypeScript", 0, 0, 0, 9, 1, 10
"d:\Proyecto\citasnuevo\lib\core\ads_services\Ads.dart", "Dart", 0, 64, 0, 0, 5, 69
"d:\Proyecto\citasnuevo\lib\core\common\commonUtils\DateNTP.dart", "Dart", 0, 7, 0, 0, 3, 10
"d:\Proyecto\citasnuevo\lib\core\common\common_widgets.dart\errorWidget.dart", "Dart", 0, 16, 0, 0, 2, 18
"d:\Proyecto\citasnuevo\lib\core\common\profileCharacteristics.dart", "Dart", 0, 28, 0, 0, 8, 36
"d:\Proyecto\citasnuevo\lib\core\dependencies\dependencyCreator.dart", "Dart", 0, 147, 0, 35, 20, 202
"d:\Proyecto\citasnuevo\lib\core\dependencies\error\Exceptions.dart", "Dart", 0, 59, 0, 1, 8, 68
"d:\Proyecto\citasnuevo\lib\core\dependencies\error\Failure.dart", "Dart", 0, 24, 0, 0, 5, 29
"d:\Proyecto\citasnuevo\lib\core\firebase_services\firebase_auth.dart", "Dart", 0, 21, 0, 0, 10, 31
"d:\Proyecto\citasnuevo\lib\core\globalData.dart", "Dart", 0, 2, 0, 0, 1, 3
"d:\Proyecto\citasnuevo\lib\core\iapPurchases\iapPurchases.dart", "Dart", 0, 59, 0, 1, 7, 67
"d:\Proyecto\citasnuevo\lib\core\location_services\locatio_service.dart", "Dart", 0, 38, 0, 12, 14, 64
"d:\Proyecto\citasnuevo\lib\core\notifications\notifications_service.dart", "Dart", 0, 193, 0, 6, 35, 234
"d:\Proyecto\citasnuevo\lib\data\Mappers\ChatConverter.dart", "Dart", 0, 67, 0, 0, 9, 76
"d:\Proyecto\citasnuevo\lib\data\Mappers\MessajeConverter.dart", "Dart", 0, 1, 0, 0, 0, 1
"d:\Proyecto\citasnuevo\lib\data\Mappers\ProfilesMapper.dart", "Dart", 0, 9, 0, 0, 0, 9
"d:\Proyecto\citasnuevo\lib\data\Mappers\RewardMapper.dart", "Dart", 0, 14, 0, 0, 4, 18
"d:\Proyecto\citasnuevo\lib\data\Mappers\SettingsMapper.dart", "Dart", 0, 61, 0, 0, 8, 69
"d:\Proyecto\citasnuevo\lib\data\Mappers\UserCreatorMapper.dart", "Dart", 0, 165, 0, 0, 61, 226
"d:\Proyecto\citasnuevo\lib\data\Mappers\UserSettingsMapper.dart", "Dart", 0, 195, 0, 0, 28, 223
"d:\Proyecto\citasnuevo\lib\data\dataSources\HomeDataSource\homeScreenDataSources.dart", "Dart", 0, 60, 0, 2, 2, 64
"d:\Proyecto\citasnuevo\lib\data\dataSources\appSettings\ApplicationSettingsDataSource.dart", "Dart", 0, 125, 0, 0, 18, 143
"d:\Proyecto\citasnuevo\lib\data\dataSources\authDataSources\authDataSourceImpl.dart", "Dart", 0, -18, 0, 0, 6, -12
"d:\Proyecto\citasnuevo\lib\data\dataSources\chatDataSource\chatDataSource.dart", "Dart", 0, 15, 0, 0, 5, 20
"d:\Proyecto\citasnuevo\lib\data\dataSources\principalDataSource\principalDataSource.dart", "Dart", 0, 19, 0, 0, 3, 22
"d:\Proyecto\citasnuevo\lib\data\dataSources\reactionDataSources\reactionDataSource.dart", "Dart", 0, 9, 0, 0, -2, 7
"d:\Proyecto\citasnuevo\lib\data\dataSources\rewardsDataSource\rewardDataSource.dart", "Dart", 0, 72, 0, -4, 1, 69
"d:\Proyecto\citasnuevo\lib\data\dataSources\sanctionsDataSource.dart\sanctionsDataSource.dart", "Dart", 0, 76, 0, 1, 17, 94
"d:\Proyecto\citasnuevo\lib\data\dataSources\settingsDataSource\settingsDataSource.dart", "Dart", 0, 44, 0, 0, -1, 43
"d:\Proyecto\citasnuevo\lib\data\dataSources\userCreatorDataSource\userCreator.DataSource.dart", "Dart", 0, 151, 0, 5, 30, 186
"d:\Proyecto\citasnuevo\lib\data\dataSources\userSettingsDataSource\userSettingsDataSource.dart", "Dart", 0, 202, 0, 3, 39, 244
"d:\Proyecto\citasnuevo\lib\data\repositoryImpl\appSettingsRepoImpl\appSettingsRepo.dart", "Dart", 0, 67, 0, 2, 12, 81
"d:\Proyecto\citasnuevo\lib\data\repositoryImpl\authRepoImpl\authRepoImpl.dart", "Dart", 0, -6, 0, 0, 2, -4
"d:\Proyecto\citasnuevo\lib\data\repositoryImpl\homeScreenRepoImpl.dart\homeScreenRepoImpl.dart", "Dart", 0, 34, 0, 1, 2, 37
"d:\Proyecto\citasnuevo\lib\data\repositoryImpl\reactionRepoImpl\reactionRepoImpl.dart", "Dart", 0, -13, 0, 0, 1, -12
"d:\Proyecto\citasnuevo\lib\data\repositoryImpl\rewardRepoImpl\rewardRepoImpl.dart", "Dart", 0, 64, 0, 0, 10, 74
"d:\Proyecto\citasnuevo\lib\data\repositoryImpl\sanctionsRepoImpl\sanctionsRepoImpl.dart", "Dart", 0, 41, 0, 1, 9, 51
"d:\Proyecto\citasnuevo\lib\data\repositoryImpl\settingsRepoImpl\settingsRepoImpl.dart", "Dart", 0, 4, 0, 0, 1, 5
"d:\Proyecto\citasnuevo\lib\data\repositoryImpl\userCreatorRepoImpl\userCreatorRepoImpl.dart", "Dart", 0, 49, 0, 0, 11, 60
"d:\Proyecto\citasnuevo\lib\data\repositoryImpl\userSettingsRepoImpl.dart\userSettingsRepoImpl.dart", "Dart", 0, 57, 0, 0, 10, 67
"d:\Proyecto\citasnuevo\lib\domain\controller\SettingsController.dart", "Dart", 0, 74, 0, 0, 10, 84
"d:\Proyecto\citasnuevo\lib\domain\controller\appSettingsController.dart", "Dart", 0, 86, 0, 2, 14, 102
"d:\Proyecto\citasnuevo\lib\domain\controller\authScreenController.dart", "Dart", 0, -3, 0, 0, 2, -1
"d:\Proyecto\citasnuevo\lib\domain\controller\chatController.dart", "Dart", 0, 94, 0, 7, 11, 112
"d:\Proyecto\citasnuevo\lib\domain\controller\controllerDef.dart", "Dart", 0, 87, 0, 37, 17, 141
"d:\Proyecto\citasnuevo\lib\domain\controller\homeScreenController.dart", "Dart", 0, 71, 0, 3, 10, 84
"d:\Proyecto\citasnuevo\lib\domain\controller\reactionsController.dart", "Dart", 0, 84, 0, 8, 12, 104
"d:\Proyecto\citasnuevo\lib\domain\controller\reportController.dart", "Dart", 0, -1, 0, 0, 0, -1
"d:\Proyecto\citasnuevo\lib\domain\controller\rewardController.dart", "Dart", 0, 154, 0, 0, 34, 188
"d:\Proyecto\citasnuevo\lib\domain\controller\sanctionsController.dart", "Dart", 0, 61, 0, 1, 12, 74
"d:\Proyecto\citasnuevo\lib\domain\controller\userCreatorController.dart", "Dart", 0, 75, 0, 0, 16, 91
"d:\Proyecto\citasnuevo\lib\domain\controller\userSettingsController.dart", "Dart", 0, 80, 0, 0, 20, 100
"d:\Proyecto\citasnuevo\lib\domain\controller_bridges\HomeScreenCotrollerBridge.dart", "Dart", 0, 23, 0, 0, 10, 33
"d:\Proyecto\citasnuevo\lib\domain\controller_bridges\RewardScreenControllerBridge.dart", "Dart", 0, 23, 0, 0, 6, 29
"d:\Proyecto\citasnuevo\lib\domain\controller_bridges\SettingsToAppSettingsControllerBridge.dart", "Dart", 0, 21, 0, 0, 6, 27
"d:\Proyecto\citasnuevo\lib\domain\controller_bridges\UserSettingsToSettingsControllerBridge.dart", "Dart", 0, 19, 0, 0, 6, 25
"d:\Proyecto\citasnuevo\lib\domain\entities\ApplicationSettingsEntity.dart", "Dart", 0, 20, 0, 0, 1, 21
"d:\Proyecto\citasnuevo\lib\domain\entities\ChatEntity.dart", "Dart", 0, 1, 0, 0, 0, 1
"d:\Proyecto\citasnuevo\lib\domain\entities\ReactionEntity.dart", "Dart", 0, 14, 0, 0, 1, 15
"d:\Proyecto\citasnuevo\lib\domain\entities\RewardsEntity.dart", "Dart", 0, 3, 0, -1, 0, 2
"d:\Proyecto\citasnuevo\lib\domain\entities\SanctionsEntity.dart", "Dart", 0, 34, 0, 11, 9, 54
"d:\Proyecto\citasnuevo\lib\domain\entities\SettingsEntity.dart", "Dart", 0, 26, 0, 0, 3, 29
"d:\Proyecto\citasnuevo\lib\domain\entities\UserCreatorEntity.dart", "Dart", 0, 52, 0, 0, 11, 63
"d:\Proyecto\citasnuevo\lib\domain\entities\UserSettingsEntity.dart", "Dart", 0, 73, 0, 0, 15, 88
"d:\Proyecto\citasnuevo\lib\domain\repository\appSettingsRepo\appSettingsRepo.dart", "Dart", 0, 14, 0, 0, 7, 21
"d:\Proyecto\citasnuevo\lib\domain\repository\appSettingsRepo\userSettingsRepo.dart", "Dart", 0, 13, 0, 0, 7, 20
"d:\Proyecto\citasnuevo\lib\domain\repository\homeScreenRepo\homeScreenRepo.dart", "Dart", 0, 4, 0, 0, 2, 6
"d:\Proyecto\citasnuevo\lib\domain\repository\reactionRepository\reactionRepository.dart", "Dart", 0, -1, 0, -5, 1, -5
"d:\Proyecto\citasnuevo\lib\domain\repository\rewardRepository\rewardRepository.dart", "Dart", 0, 13, 0, 0, 6, 19
"d:\Proyecto\citasnuevo\lib\domain\repository\sanctionsRepo\sanctionsRepo.dart", "Dart", 0, 11, 0, 0, 5, 16
"d:\Proyecto\citasnuevo\lib\domain\repository\settingsRepository\SettingsRepository.dart", "Dart", 0, 1, 0, 0, 1, 2
"d:\Proyecto\citasnuevo\lib\domain\repository\userCreatorRepo\userCreatorRepo.dart", "Dart", 0, 10, 0, 0, 6, 16
"d:\Proyecto\citasnuevo\lib\main.dart", "Dart", 0, 3, 0, 1, 3, 7
"d:\Proyecto\citasnuevo\lib\presentation\appSettingsPresentation\appSettingsPresentation.dart", "Dart", 0, 137, 0, 2, 18, 157
"d:\Proyecto\citasnuevo\lib\presentation\appSettingsPresentation\appSettingsScreen.dart", "Dart", 0, 309, 0, 1, 13, 323
"d:\Proyecto\citasnuevo\lib\presentation\authScreenPresentation\Screens\authScreen.dart", "Dart", 0, 33, 0, 0, 3, 36
"d:\Proyecto\citasnuevo\lib\presentation\authScreenPresentation\auth.dart", "Dart", 0, 24, 0, -1, 2, 25
"d:\Proyecto\citasnuevo\lib\presentation\chatPresentation\Widgets\chatMessage.dart", "Dart", 0, -2, 0, 0, 0, -2
"d:\Proyecto\citasnuevo\lib\presentation\chatPresentation\Widgets\chatProfileDetailScreen.dart", "Dart", 0, 1, 0, 0, 0, 1
"d:\Proyecto\citasnuevo\lib\presentation\chatPresentation\Widgets\chatScreen.dart", "Dart", 0, 4, 0, 0, -2, 2
"d:\Proyecto\citasnuevo\lib\presentation\chatPresentation\chatPresentation.dart", "Dart", 0, 73, 0, 1, 4, 78
"d:\Proyecto\citasnuevo\lib\presentation\homeReportScreenPresentation\ReportScreen.dart", "Dart", 0, 28, 0, 0, 0, 28
"d:\Proyecto\citasnuevo\lib\presentation\homeReportScreenPresentation\homeReportScreenPresentation.dart", "Dart", 0, 2, 0, 0, 1, 3
"d:\Proyecto\citasnuevo\lib\presentation\homeScreenPresentation\Screens\HomeScreen.dart", "Dart", 0, 230, 0, -1, 17, 246
"d:\Proyecto\citasnuevo\lib\presentation\homeScreenPresentation\Widgets\NavigationBar.dart", "Dart", 0, 139, 0, 0, 0, 139
"d:\Proyecto\citasnuevo\lib\presentation\homeScreenPresentation\Widgets\ProfileDescription.dart", "Dart", 0, 15, 0, 0, 2, 17
"d:\Proyecto\citasnuevo\lib\presentation\homeScreenPresentation\Widgets\ProfilePicture.dart", "Dart", 0, 2, 0, 0, 3, 5
"d:\Proyecto\citasnuevo\lib\presentation\homeScreenPresentation\Widgets\profileWidget.dart", "Dart", 0, 4, 0, 0, 0, 4
"d:\Proyecto\citasnuevo\lib\presentation\homeScreenPresentation\homeScrenPresentation.dart", "Dart", 0, 109, 0, 34, 18, 161
"d:\Proyecto\citasnuevo\lib\presentation\reactionPresentation\Screens\ReactionScreen.dart", "Dart", 0, -215, 0, 0, -17, -232
"d:\Proyecto\citasnuevo\lib\presentation\reactionPresentation\Widgets\RevealingCard.dart", "Dart", 0, 349, 0, 0, 19, 368
"d:\Proyecto\citasnuevo\lib\presentation\reactionPresentation\reactionPresentation.dart", "Dart", 0, 224, 0, 0, 15, 239
"d:\Proyecto\citasnuevo\lib\presentation\rewardScreenPresentation\rewardScreen.dart", "Dart", 0, 684, 0, 0, 12, 696
"d:\Proyecto\citasnuevo\lib\presentation\rewardScreenPresentation\rewardScreenPresentation.dart", "Dart", 0, 273, 0, 0, 44, 317
"d:\Proyecto\citasnuevo\lib\presentation\sanctionsPresentation\sanctionsPresentation.dart", "Dart", 0, 90, 0, 4, 20, 114
"d:\Proyecto\citasnuevo\lib\presentation\sanctionsPresentation\sanctionsScreen.dart", "Dart", 0, 205, 0, 0, 5, 210
"d:\Proyecto\citasnuevo\lib\presentation\settingsPresentation\SettingsScreen.dart", "Dart", 0, 439, 0, 0, 8, 447
"d:\Proyecto\citasnuevo\lib\presentation\settingsPresentation\settingsScreenPresentation.dart", "Dart", 0, 31, 0, 0, 8, 39
"d:\Proyecto\citasnuevo\lib\presentation\userCreatorPresentation\userCreatorPresentation.dart", "Dart", 0, 154, 0, 3, 34, 191
"d:\Proyecto\citasnuevo\lib\presentation\userCreatorPresentation\userCreatorScreen.dart", "Dart", 0, 1210, 0, 1, 60, 1271
"d:\Proyecto\citasnuevo\lib\presentation\userSettingsPresentation\userPresentation.dart", "Dart", 0, 122, 0, 2, 26, 150
"d:\Proyecto\citasnuevo\lib\presentation\userSettingsPresentation\userSettingsScreen.dart", "Dart", 0, 605, 0, 2, 47, 654
"d:\Proyecto\citasnuevo\lib\reordableList.dart", "Dart", 0, 188, 0, 32, 29, 249
"d:\Proyecto\citasnuevo\lib\reordableLists\drag_info.dart", "Dart", 0, 180, 0, 13, 49, 242
"d:\Proyecto\citasnuevo\lib\reordableLists\reorderable_grid_mixin.dart", "Dart", 0, 188, 0, 36, 53, 277
"d:\Proyecto\citasnuevo\lib\reordableLists\reorderable_item.dart", "Dart", 0, 139, 0, 18, 30, 187
"d:\Proyecto\citasnuevo\lib\reordableLists\reorderable_sliver_grid_view.dart", "Dart", 0, 57, 0, 8, 13, 78
"d:\Proyecto\citasnuevo\lib\reordableLists\reorderable_wrapper_widget.dart", "Dart", 0, 75, 0, 43, 26, 144
"d:\Proyecto\citasnuevo\lib\reordableLists\sliver_grid_with_reorderable_pos_delegate.dart", "Dart", 0, 25, 0, 2, 3, 30
"d:\Proyecto\citasnuevo\lib\reordableLists\test_grid.dart", "Dart", 0, 10, 0, 0, 2, 12
"d:\Proyecto\citasnuevo\lib\reordableLists\util.dart", "Dart", 0, 6, 0, 1, 3, 10
"d:\Proyecto\citasnuevo\pubspec.yaml", "YAML", 17, 0, 0, 0, 2, 19
"Total", "-", 17, 9608, 193, 369, 1407, 11594